2025.06.11护理记录								
血糖：2.9 mmol/l;	血糖：2.9 mmol/l;			血压：142/77mmHg		体温：36.7℃		心率:88次/分
								
主诉：;泡沫尿9年余，腹透液引流不畅3天;	主诉：;泡沫尿9年余，腹透液引流不畅3天;							
								
								
Braden评分：20分;跌倒评分：60分;ADL评分：50分;	Braden评分：20分;跌倒评分：60分;ADL评分：50分;							
导管评估:	导管评估:							
其他导管:名称:腹膜透析导管 深度:无 固定:妥 通畅:是  感染迹象:否 局部渗出:无危险程度:中危置管日期:是否拔管:备注:置管日期不详。	其他导管:名称:腹膜透析导管 深度:无 固定:妥 通畅:是  感染迹象:否 局部渗出:无危险程度:中危置管日期:是否拔管:备注:置管日期不详。							
神经系统评估：无明显异常;	神经系统评估：无明显异常;							
呼吸系统评估：无明显异常;	呼吸系统评估：无明显异常;							
心血管系统评估：无明显异常;	心血管系统评估：无明显异常;							
消化系统评估:进食方式：自主;食欲：好;饮食：饮食自备 (:糖尿病);;恶心：无;呕吐：无;腹部膨隆：无;腹胀：无;腹痛：无;肠鸣音：正常肛门排气：有;	消化系统评估:进食方式：自主;食欲：好;饮食：饮食自备 (:糖尿病);;恶心：无;呕吐：无;腹部膨隆：无;腹胀：无;腹痛：无;肠鸣音：正常肛门排气：有;							
泌尿生殖系统评估：排尿：无尿;透析：血透;动静脉瘘：有部位左上肢杂音：有;尿量：无尿(少于100Ml/天);尿色：淡黄有泡沫;	泌尿生殖系统评估：排尿：无尿;透析：血透;动静脉瘘：有部位左上肢杂音：有;尿量：无尿(少于100Ml/天);尿色：淡黄有泡沫;							
皮肤粘膜评估：皮肤温度：温暖;水肿：左下肢凹陷性右下肢凹陷性;	皮肤粘膜评估：皮肤温度：温暖;水肿：左下肢凹陷性右下肢凹陷性;							
								
								
运动系统评估：无明显异常;	运动系统评估：无明显异常;							
精神心理评估：无明显异常;	精神心理评估：无明显异常;							
护理措施：汇报医生 继续观察 ;	护理措施：汇报医生 继续观察 ;							
教育内容：★入院宣教--	教育内容：★入院宣教--							
★疼痛护理-★疼痛教育-疼痛教育（通用）	★疼痛护理-★疼痛教育-疼痛教育（通用）							
★饮食与营养-低盐低脂优质低蛋白饮食-低盐低脂优质低蛋白饮食	★饮食与营养-低盐低脂优质低蛋白饮食-低盐低脂优质低蛋白饮食							
;;	;;							
患者存在{自理缺陷}的问题，予：观察评估患者的自理能力，观察是否需要辅助器材，出院后是否需要家庭健康照顾。|观察患者所处环境及所使用物品是否安全易得，创造安全方便的环境。|;	患者存在{自理缺陷}的问题，予：观察评估患者的自理能力，观察是否需要辅助器材，出院后是否需要家庭健康照顾。|观察患者所处环境及所使用物品是否安全易得，创造安全方便的环境。|;							
